0000000000000000
0000000000000000
0000000000000000
0000000000000000
0000000000000000
0000003000000000
0000033000000000
0001333200000000
